/documentation/foundationmodels	docs/_sources/apple/documentation/foundationmodels.json
/documentation/foundationmodels/adding-intelligent-app-features-with-generative-models	docs/_sources/apple/documentation/foundationmodels/adding-intelligent-app-features-with-generative-models.json
/documentation/foundationmodels/analyzing-the-runtime-performance-of-your-foundation-models-app	docs/_sources/apple/documentation/foundationmodels/analyzing-the-runtime-performance-of-your-foundation-models-app.json
/documentation/foundationmodels/expanding-generation-with-tool-calling	docs/_sources/apple/documentation/foundationmodels/expanding-generation-with-tool-calling.json
/documentation/foundationmodels/generable	docs/_sources/apple/documentation/foundationmodels/generable.json
/documentation/foundationmodels/generate-dynamic-game-content-with-guided-generation-and-tools	docs/_sources/apple/documentation/foundationmodels/generate-dynamic-game-content-with-guided-generation-and-tools.json
/documentation/foundationmodels/generating-content-and-performing-tasks-with-foundation-models	docs/_sources/apple/documentation/foundationmodels/generating-content-and-performing-tasks-with-foundation-models.json
/documentation/foundationmodels/generating-swift-data-structures-with-guided-generation	docs/_sources/apple/documentation/foundationmodels/generating-swift-data-structures-with-guided-generation.json
/documentation/foundationmodels/generationoptions	docs/_sources/apple/documentation/foundationmodels/generationoptions.json
/documentation/foundationmodels/improving-the-safety-of-generative-model-output	docs/_sources/apple/documentation/foundationmodels/improving-the-safety-of-generative-model-output.json
/documentation/foundationmodels/instructions	docs/_sources/apple/documentation/foundationmodels/instructions.json
/documentation/foundationmodels/languagemodelfeedback	docs/_sources/apple/documentation/foundationmodels/languagemodelfeedback.json
/documentation/foundationmodels/languagemodelsession	docs/_sources/apple/documentation/foundationmodels/languagemodelsession.json
/documentation/foundationmodels/prompt	docs/_sources/apple/documentation/foundationmodels/prompt.json
/documentation/foundationmodels/prompting-an-on-device-foundation-model	docs/_sources/apple/documentation/foundationmodels/prompting-an-on-device-foundation-model.json
/documentation/foundationmodels/supporting-languages-and-locales-with-foundation-models	docs/_sources/apple/documentation/foundationmodels/supporting-languages-and-locales-with-foundation-models.json
/documentation/foundationmodels/systemlanguagemodel	docs/_sources/apple/documentation/foundationmodels/systemlanguagemodel.json
/documentation/foundationmodels/systemlanguagemodel/usecase	docs/_sources/apple/documentation/foundationmodels/systemlanguagemodel/usecase.json
/documentation/foundationmodels/tool	docs/_sources/apple/documentation/foundationmodels/tool.json
/documentation/foundationmodels/transcript	docs/_sources/apple/documentation/foundationmodels/transcript.json
/documentation/technologies	docs/_sources/apple/documentation/technologies.json
/documentation/speech	docs/_sources/apple/documentation/speech.json
/documentation/speech/analysiscontext	docs/_sources/apple/documentation/speech/analysiscontext.json
/documentation/speech/analyzerinput	docs/_sources/apple/documentation/speech/analyzerinput.json
/documentation/speech/assetinstallationrequest	docs/_sources/apple/documentation/speech/assetinstallationrequest.json
/documentation/speech/assetinventory	docs/_sources/apple/documentation/speech/assetinventory.json
/documentation/speech/bringing-advanced-speech-to-text-capabilities-to-your-app	docs/_sources/apple/documentation/speech/bringing-advanced-speech-to-text-capabilities-to-your-app.json
/documentation/speech/dictationtranscriber	docs/_sources/apple/documentation/speech/dictationtranscriber.json
/documentation/speech/localedependentspeechmodule	docs/_sources/apple/documentation/speech/localedependentspeechmodule.json
/documentation/speech/sfcustomlanguagemodeldata	docs/_sources/apple/documentation/speech/sfcustomlanguagemodeldata.json
/documentation/speech/sfspeechlanguagemodel	docs/_sources/apple/documentation/speech/sfspeechlanguagemodel.json
/documentation/speech/sfspeechlanguagemodel/configuration	docs/_sources/apple/documentation/speech/sfspeechlanguagemodel/configuration.json
/documentation/speech/speech-recognition-in-objc	docs/_sources/apple/documentation/speech/speech-recognition-in-objc.json
/documentation/speech/speechanalyzer	docs/_sources/apple/documentation/speech/speechanalyzer.json
/documentation/speech/speechdetector	docs/_sources/apple/documentation/speech/speechdetector.json
/documentation/speech/speechmodels	docs/_sources/apple/documentation/speech/speechmodels.json
/documentation/speech/speechmodule	docs/_sources/apple/documentation/speech/speechmodule.json
/documentation/speech/speechmoduleresult	docs/_sources/apple/documentation/speech/speechmoduleresult.json
/documentation/speech/speechtranscriber	docs/_sources/apple/documentation/speech/speechtranscriber.json
/documentation/technologies	docs/_sources/apple/documentation/technologies.json